1
D4D-D4D-D-D-D-D-
R-R-R-R-R4R-R-R3
R-R-R-R-R-R-R-R-
R5R-R3R-R4R-R5R-
R-R-R-R-R-R-R-R-
R-R4R-R-R-R3R-R-
_-_-_-_-_-_-_-_-
_-_-_-_-_-_-_-_-

2
R-_-_-_-_-_-_-_-
R-R-_-_-_-_-_-_-
R-R-R-_-_-_-_-_-
R4R-R-R5_-_-_-_-
R-R-R-R-R4_-_-_-
R-R5R-R-R-R-_-_-
R-R-R-R-R-R-R-_-
D-D-D4D-D-D3D-D- 