R_R_R_R_R_R_R_R_
R_RsR_R_RtR_R_R_
D_D_D_D_D_D_D_D_
__________________
RmR_R_R_R_R_R_R_
R_R_R_R_R_R_R_R_
D_D_D_D_D_D_D_D_
__________________
R_R_R_R_R_R_R_R_
R_R_R_R_R_R_R_R_
D_D_D_D_D_D_D_D_
__________________
R_R_R_R_R_R_R_R_
R_R_R_R_R_R_R_R_
D_D_D_D_D_D_D_D_
__________________
R_R_R_R_R_R_R_R_
R_R_R_R_R_R_R_R_
D_D_D_D_D_D_D_D_
__________________ 